3 3
*******
    * *
*** * *
* * * *
* * ***
* *   *
*******